R  1280 720
NO ./textures/brick.xpm   
SO ./textures/blue.xpm
WE ./textures/wood.xpm
EA ./textures/grey.xpm

S ./textures/tree.xpm
F 224,172,105
C 205,249,255

  11111111111111111111111111111
  10000000001100000000000000001
  10110000011100020000W00010001
1110120000000000000000000010001
1011000001110000000000021000111
10000000001100000111011110001
11110111111111011100000010001
11110111111111011101010000001
11000000110101011000000000001
10002000000000000000000000001
10000000000000001101010010001
11000000110101011111011110001
11110111111101011111011110001
11111111111111111111111111111